PLAYER 1 1
DOOR 9 7
GATE 7 6
BOMB 7 5
SECONDS 75
SIZE 10 9
BOARD
AAAA BBBB BBBB BBBB BBBB BBBB BBBB BBBB BBBB CCCC
AAAA BBBB BBBB BBBB BBBB BBBB BBBB BBBB BBBB CCCC
AAAA DDCC DDDD DDDD BBBB BBBB ACAC CCCC CCCC CCCC
AAAA BBBB BBBB BBBB BBBB BBBB BBBB BBBB BBBB CCCC
AAAA DDCC CCCC CACA BBBB BBBB CACA AAAA AAAA CCCC
AAAA BBBB BBBB BBBB BBBB BBBB BBBB BBBB BBBB CCCC
AAAA AAAA AAAA ADAD BBBB BBBB DDDD DDDD DDDD CCCC
AAAA BBBB BBBB BBBB BBBB BBBB BBBB BBBB BBBB CCCC
AAAA BBBB BBBB BBBB BBBB BBBB BBBB BBBB BCBC CCCC