PLAYER 3 1
DOOR 10 1
SIZE 10 9
SECONDS 50
BOARD
DDDD CDCD CCCC CCCC CCCC CCCC CCCC CCCC CCCC DDDD
CCCC ABAB BBBB CCCC AAAA AAAA CCCC BBBB BABA CCCC
CCCC AAAA CCCC CCCC AAAA CCCC CCCC AAAA CCCC CCCC
CCCC AAAA AAAA AAAA AAAA CCCC CCCC AAAA CCCC CCCC
CCCC AAAA CCCC CCCC AAAA ACAC CCCC AAAA CCCC CCCC
CCCC AAAA CCCC CCCC AAAA AAAA AAAA AAAA AAAA CCCC
CCCC AAAA AAAA AAAA CCCC AAAA CCCC CCCC CCCC CCCC
CCCC ABAB BBBB AAAA CCCC AAAA CCCC BBBB BABA CCCC
DDDD ACAC CCCC CCCC CCCC CCCC CCCC CCCC CCCC DDDD