PLAYER, 1, 1
ASSASSIN, RIGHT, 2, 7
DOOR, 6, 5
GATE1, 4, 5
LEVER, GOLD, 3, 3
SECONDS, 80
BOMB, 3, 7
BOMB, 8, 7
COIN, BRONZE, 4, 2
COIN, BRONZE, 2, 4
COIN, BRONZE, 4, 7
COIN, SILVER, 5, 7
COIN, GOLD, 6, 7
COIN, PLAT, 7, 7
CLOCK, 7, 4
CLOCK, 9, 3
COIN, PLAT, 8, 1
COIN, BRONZE, 9, 5
SIZE, 10, 9
BOARD
DDDD DDDD DDDD DDDD AADD ADAA DDDD DDDD DDDD DDDD
DDDD DDDD DDDD DDDD DDDA DAAA ADAA DDDD DDDD DDDD
DDDD DDDD DDDD DDDD DAAA AAAB BABB ADAA DDDD DDDD
DDDD DDDD DDDD DDDA AAAA ABBB BBBB AAAD DDDD DDDD
DDDC DDDD DDDA AAAA ABBB BBBB BBBA ADAC DDDC DDDC
CCCC CDCC AAAA BBBB BBBB BBBB BBBB AAAA ACAA CCCC
CCCC CAAA BBBB AAAA AAAA AAAA AAAA BBBB AAAA CCCC
CCCC AACA BBAB BBBB BBBB BBBB BBBB BBBA AAAC CCCC
CCCC CACC AAAA AAAA AAAA AAAA AAAA AAAC CCCC CCCC