PLAYER 1 1
DOOR 6 5
SECONDS 75
SIZE 10 9
BOARD
AAAA AAAA AAAA AAAA AAAA AAAA AAAA AAAA AAAA AAAA
AAAA BBBB BBBB BBBB BBBB BBBB BBBB BBBB BBBB AAAA
AAAA BCCB CBBC CCCC CCCC CCCC CCCC CBBC BCCB AAAA
ADDA BBBB CCCC DAAD DDDD DDDD DAAD CCCC BBBB ADDA
AAAA BDDB CCCC DBBD DDDD DDDD DBBD CCCC BDDB AAAA
ADDA BBBB CCCC DAAD DDDD DDDD DAAD CCCC BBBB ADDA
AAAA BCCB CBBC CCCC CCCC CCCC CCCC CBBC BCCB AAAA
AAAA BBBB BBBB BBBB BBBB BBBB BBBB BBBB BBBB AAAA
AAAA AAAA AAAA AAAA AAAA AAAA AAAA AAAA AAAA AAAA