PLAYER 1 1
ASSASSIN RIGHT 8 6
FFTHIEF D RIGHT ANTICLOCKWISE 9 8
STHIEF 5 5
COIN BRONZE 2 5
COIN SILVER 7 5

CLOCK 8 8
DOOR 5 9
GATE1 1 3
GATE2 9 7
LEVER GOLD 4 9
LEVER SILVER 1 1
BOMB 6 3
SECONDS 55
SIZE 10 9
BOARD
AAAA BBBB CCCC DDDD DDDD DDDD DDDD DDDD DDDD DDDD
AAAA BBBB CCCC BBBB BBBB DDDD CCCC DDDD AAAA DDDD
ADDA BBBB CCCC DDDD DDDD DDDD DDDD DDDD DDDD DDDD
AAAA BBBB CCCC AAAA DDDD DDDD BBBB DDDD CCCC DDDD
AAAA BDDB CCCC DDDD DDDD DDDD DDDD DDDD DDDD DDDD
AAAA BBBB CCCC CCCC DDDD DDDD AAAA AAAA DDDD DDDD
AAAA BBBB CDDC DDDD DDDD BBBB DDDD DDDD DDDD DDDD
AAAA BBBB CCCC DDDD DDDD DDDD DDDD BBBB DDDD DDDD
AAAA BBBB CCCC DDDD BBBB BBBB DDDD DDDD DDDD DDDD
