PLAYER 1 1
ASSASSIN RIGHT 8 6
FFTHIEF D RIGHT 9 8
STHIEF 5 5
COIN BRONZE 2 5
COIN SILVER 7 5
COIN GOLD 5 3
COIN GOLD 9 5
DOOR 6 8
GATE2 10 2
COIN GOLD 8 7
LEVER SILVER 10 5
BOMB 6 3
SECONDS 50
SIZE 10 9
BOARD
AAAA BBBB CCCC DDDD DDDD DDDD DDDD DDDD DDDD DDDD
AAAA BBBB CCCC BBBB BBBB DDDD CCCC DDDD AAAA DDDD
ADDA BBBB CCCC DDDD DDDD DDDD DDDD DDDD DDDD DDDD
AAAA BBBB CCCC AAAA DDDD DDDD BBBB DDDD CCCC DDDD
AAAA BDDB CCCC DDDD DDDD DDDD DDDD DDDD DDDD DDDD
AAAA BBBB CCCC CCCC DDDD DDDD AAAA AAAA DDDD DDDD
AAAA BBBB CDDC DDDD DDDD BBBB DDDD DDDD DDDD DDDD
AAAA BBBB CCCC DDDD DDDD DDDD DDDD BBBB DDDD DDDD
AAAA BBBB CCCC DDDD BBBB BBBB DDDD DDDD DDDD DDDD
