PLAYER, 1, 1
ASSASSIN, UP, 3, 8
DOOR, 9, 7
GATE1, 7, 6
COIN, GOLD, 3, 1
COIN, GOLD, 3, 2
COIN, SILVER, 3, 3
COIN, SILVER, 3, 4
COIN, BRONZE, 3, 5
COIN, BRONZE, 3, 6
COIN, BRONZE, 3, 7
BOMB, 3, 9
BOMB, 7, 3
CLOCK, 7, 4
GATE2, 5, 1
LEVER, SILVER, 7, 5
LEVER, GOLD, 5, 8
SECONDS, 75
SIZE, 10, 9
BOARD
CCCC CCCC AAAA CCCC CCCC CCCC CCAA BBBB BBBB BBBB
CCCC DDDD AAAA DDDD DDDD DDDD DDDD DDDD DDDD BBBB
CCCC DDDD AAAA DDDD DDDD DDDD DDDD DDDD DDDD AAAA
CCCC DDDD AAAA DDDD DDDD DDDD AAAA DDDD DDDD CCCC
CCCC DDDD AAAA DDDD DDDD DDDD AAAA DDDD DDDD CCCC
CCCC DDDD AAAA DDDD DDDD DDDD AAAA DDDD DDDD CCCC
DACB DDDD AAAA AAAA AAAA AAAA AAAA AAAA AAAA BDDB
BBBB DDDD DDDD DDDD DDDD DDDD AAAA DDDD DDDD CCCC
BBBB BBBB BBBB BBBB BBBB BBBB AAAA CCCC CCCC CCCC